111111111111111
10010000000C001
100C01111X00001
110011E00000001
10P000000000001
100000000000001
111111111111111