111111111111111
10010000000C001
10000111110C001
1P00110000000111
1001000000E0001
100100000000001
100100000E00001
100000000000001
100000000000001
111111111111111