1111111111
111CE0X001
1000011011
1111P00001
1111111111