111111111111111111
10CX01111000000C01
1000C1000000000001
100001000000000001
100001100001000001
100001011000000001
100011001000000001
10P001001110000001
10C000000000000E01
111111111111111111