111111111111111111
10C011111111111C01
100010000000100001
10001010010010C001
100010000000100001
100010X000X0100001
10P010011001111E01
100000000010000001
10000000000C000001
111111111111111111