111111111111111111
1C0001111000000111
100011111100010001
10001100100C000001
100011000001000001
10000000000X000001
10P001111000000001
100000110000000C01
1000001000000CE001
111111111111111111