111111111111111111
10C001111000000C01
100001111110110001
111100011110000001
110000001100001111
1000000011C0000111
10P0001110E0000111
10000C001000000011
111000000000000011
111111111111111111