111111111111111111
100111000000000001
100001111000000001
100001011000000001
100000001000111C11
100000000000100001
10P00C111111000011
100001111000000111
1000C10000E0000001
111111111111111111