111111111111111111
1XC1011110011001E1
100001001000000001
100011001100000X01
1000110X1100010001
100000001C00000001
10P001111100000001
1C000000000001C001
100011001000000101
111111111111111111