111111111111111111
100C01111000000C01
1000X10010E0000001
100001000000000001
100010C00001000001
100000C01000110111
10P001011000000001
100001001000000C11
10C001000010001111
111111111111111111