111111111111111111
10010X000000C00111
100001111100001C01
110011000000000011
100100000000X01001
10010000000X001001
1001111C0000001111
10000000000X001001
100100000000001111
10P000X000X0000111
10000000E000001111
100000000000000C01
111111111111111111
