11111111111111111111111111
1CCCCCCCCCCC10CCCCCCCCCCC1
1C1111C1111C10C1111C1111C1
1C1111C1111C10C1111C1111C1
1C1111C1111C10C1111C1111C1
1CCCCCCCCCCCC0CCCCCCCCCCC1
1C1111C1C11110111C1C1111C1
1ECCCCC0010XXXX0100CCCCC11
111111C101111011101C111111
111111C100000000001C111111
111111C101111011101C111111
1CCCCCCCCCCC10PCCCCCCCCCC1
11111111111111111111111111
