11111111111111
1C0001CCCC0001
10001110000001
1P001110000001
101111CCCC0001
100E1110000001
11111111111111
