11111111111
111C10C0011
10000001111
1000011E111
1111P000011
11111111111