111111111111111
10010000000C001
1000C1111100001
110011E00000001
100100000001001
100100000000001
10PC00100000001
10000C000C00001
110000000000001
111111111111111