111111111111111111
10CX01111000000C01
1000010X1000000001
1000X1001000000001
10000111100X000001
100000000000000001
1000X1111000000001
100001001000000001
100001001000000001
10P001111000000001
100000000000000C01
10C00000X000000E01
111111111111111111