111111111111111111
10C001111000000C01
100001001000010001
100001001000000001
100001111001000001
10000000000X000001
10P001111000000001
100000000000000C01
10C000000000000E01
111111111111111111