111111111111111111
10C001111000000C01
1000X10010E0000001
100011001000000001
100000000001000001
100001C01000000001
10P000011000000001
100000001000000C01
10C000000010000011
111111111111111111