111111111111111111
100000000000000C01
100000111000000001
100000011000000001
100000011000000001
100000011000000001
10P000111111000011
100001111000000C01
1000010000E0000001
111111111111111111