111111111111111111
10C011111111111C01
100010000000100001
100010100110100001
100010000000100001
100010X000X0100001
10P011111001111E01
100000000010000001
10C000000000000001
111111111111111111