111111111111111111
10C001111000000C01
1000X1001000000001
100001001000000001
100001111000000001
10000000000X000001
100001111000000001
100001001000000001
100001001000000001
10P001111000000001
100000000000000C01
10C0000000X00000E1
111111111111111111