111111111111111111
10CX01111000000C01
1001010X1000000001
1000X1001000000001
100001111001000001
100001001000000001
100011001000000001
10P001111000000001
10C000000000000E01
111111111111111111