111111111111111111
1XC101111001E00C01
100001001000000001
100011001100000101
100011001100010001
100000001000000001
10P001111100000001
10C000000000010C01
100011001000000101
111111111111111111