111111111111111111
10CX01111X0X0X0C01
100001001000000001
1000X1001X0X0X0X01
100001111000000001
10X0X1001X0X0X0X01
101001111000000001
1000X1001X0X0X0X01
100001001000000001
10P001111X0X0X0X01
10C000000000000C01
1000X1001X0X0X0E01
111111111111111111