111111111111111111
10C001111000000C01
100001001000000001
100001001000000001
100001111000000001
100000000000000001
10P001111000000001
100000000000000C01
10C000000000000E01
111111111111111111